Level:
Kevin Nathan
Big Bang
Bricks:
kkkkkkkkkkkkkk
kkkkkkkkkkkkkk
!!!!!!!!!!!!!!
..............
..hhhhhhhhhh..
.!.!hhhhhh!.!.
.!.!hhhhhh!.!.
.!.!hhjjhh!.!.
.!.!hjjjjh!.!.
.!.!hjjjjh!.!.
.!.!hhjjhh!.!.
.!.!hhhhhh!.!.
.!.!hhhhhh!.!.
..hhhhhhhhhh..
.!....**....!.
!vvvvvvvvvvvv!
..............
..............
Bonus:
bbbbbbbbbbbbbb
bjbbjbjjbjbbjb
55555555555555
..............
..jbbbbbbbbj..
.5.5......5.5.
.5.5b.bb.b5.5.
.5.5.b..b.5.5.
.5.5b....b5.5.
.5.5b....b5.5.
.5.5.b..b.5.5.
.5.5b.bb.b5.5.
.5.5......5.5.
..bbbjbbjbbb..
.5..........5.
5wwwwwwwwwwww5
..............
..............
Level:
Kevin Nathan
Table
Bricks:
..E........E..
.Ea........aE.
Eav..h..h..vaE
.....c..c.....
.....c..c.....
...f.c..c.i...
..fffc..ciii..
.############.
..!#......#!..
...#......#...
...#......#...
...#jj..jj#...
..!#*j..j*#!..
.#####@@#####.
.kkkkvvvvkkkk.
..............
Ev..........vE
..............
Bonus:
..............
..4........4..
.45..5..5..54.
.....4..4.....
.....4..4.....
...m.4..4.m...
..bjb4..4bjb..
..............
..m........m..
..............
..............
....55..55....
..p.m5..5m.p..
..............
.jwwsl++lswwj.
..............
.g..........g.
..............
Level:
Kevin Nathan
Pyramid
Bricks:
!............!
!!..........!!
!!!........!!!
!!!!......!!!!
!!!!!....!!!!!
!!!!!....!!!!!
!............!
!.....##.....!
!....h@@h....!
!....#..#....!
!...h@..@h...!
!...#....#...!
!..h@.zz.@h..!
...#..zz..#...
..h@......@h..
j.#........#.j
..###v##v###..
..............
Bonus:
*............*
5............5
55..........55
55j........j55
5m55......55m5
5555......5555
5............5
p............p
5....j55j....5
5............5
....&5..5&....
..............
...w5....5w...
..............
..b5......5b..
w............w
.....w..w.....
..............
Level:
Kevin Nathan
Reactor Core
Bricks:
#v..........v#
#.!!*!**!*!!.#
#.*!!!!!!!!*.#
#.!!d!!!!d!!.#
#.!!dddddd!!.#
#.*!dddddd!*.#
#.!!dddddd!!.#
#.!!dddddd!!.#
#.*!dddddd!*.#
#.!!dddddd!!.#
#.!!dddddd!!.#
#.*!d!!!!d!*.#
#.!!!!!!!!!!.#
#.!!!!!!!!!!.#
E............E
EE..........EE
EEExxxxxx*xEEE
..............
Bonus:
.m..........m.
..............
...j....j.....
..w.5....5.w..
...b55ll55b...
b...555555...b
b...555555...b
b...555555...b
w...555555j..w
....555555....
j..b55ll55b...
....5....5...j
..w..j.....w..
..............
..............
..............
...w......w...
..............
