Level:
Armish
M$ Ruins :]
Bricks:
.aaaaaaaaaa...
.aiiiafffa.a..
.aiiiafffaa.a.
.aiiiafffa.a..
.aiiiafffaa.a.
.aaaaaaaaa.a..
.agggahhhaa.a.
.agggahhha.a..
.agggahhhaa.a.
.agggahhha.a..
.aaaaaaaaaa.a.
...........a..
............a.
..............
..............
..............
..............
..............
Bonus:
..............
..............
..............
..............
..............
..............
..............
..............
..............
..............
..............
..............
..............
..............
..............
..............
..............
..............
Level:
Armish
Explosive
Bricks:
EEEEEEEEEEEEEE
cccccccccccccc
c************c
c*cccccccccc*c
c*c********c*c
c*c*cccccc*c*c
c*c******c*c*c
c*cccccccc*c*c
c**********c*c
cccccccccccc*c
EEEEEEEEEEEEcE
..............
..............
..............
..............
..............
..............
..............
Bonus:
..............
..............
..............
..............
..............
..............
..............
..............
..............
..............
..............
..............
..............
..............
..............
..............
..............
..............
Level:
Armish
Wanna play basket?
Bricks:
..............
..............
..............
....EghigE....
....EghigE....
....EghigE....
....EghigE....
....Eg**gE....
....EghigE....
....EghigE....
....EghigE....
....EghigE....
....EEEEEE....
..............
..............
..............
..............
..............
Bonus:
..............
..............
..............
..............
..............
..............
..............
..............
..............
..............
..............
..............
..............
..............
..............
..............
..............
..............
Level:
Armish
Time's important!
Bricks:
..............
.....aaa......
....afxfa.....
...affxffa....
..afffxfffa...
..afffxfffa...
..agxxxffga...
..afffffffa...
..afffffffa...
...afffffa....
....afgfa.....
.....aaa......
..............
..............
..............
..............
..............
..............
Bonus:
..............
..............
..............
..............
..............
..............
..............
..............
..............
..............
..............
..............
..............
..............
..............
..............
..............
..............
Level:
Armish
TuRKiSH FLaG
Bricks:
..............
.iiiiicciiiii.
.iiiicccciiii.
.iiicciiiiiii.
.iiiciiiiiiii.
.iicciiiiiiii.
.iicciiiiciii.
.iicciiicccii.
.iicciiiiciii.
.iicciiicicii.
.iiiciiiiiiii.
.iiicciiiiiii.
.iiiicccciiii.
.iiiiicciiiii.
..............
..............
..............
..............
Bonus:
..............
..............
..............
..............
..............
..............
..............
..............
..............
..............
..............
..............
..............
..............
..............
..............
..............
..............
Level:
Armish
What the hell...?
Bricks:
.....vvvv.....
.....vvvv.....
.....vvvv.....
.....vvvv.....
.....v**v.....
.....v**v.....
.....vvvv.....
.....vvvv.....
.....vvvv.....
.....vvvv.....
..............
.....vvvv.....
.....vvvv.....
.....vvvv.....
..............
..............
..............
..............
Bonus:
..............
..............
..............
..............
..............
..............
..............
..............
..............
..............
..............
..............
..............
..............
..............
..............
..............
..............
Level:
Armish
Ready for football?
Bricks:
ffffffjfffffff
jjxfffjfxffjjj
ffjffjjjfffxff
#fjfjfjfjffjf#
zfjfxfjfjffjfz
*xjfjfjfjffjf*
*fjfjfxfjffjx*
zfjfjfjfjffjfz
#fjffjjjfffjf#
ffxfffjffffjff
jjjfxfjfxffxjj
ffffffjfffffff
..............
..............
..............
..............
..............
..............
Bonus:
..............
..............
..............
..............
..............
..............
..............
..............
..............
..............
..............
..............
..............
..............
..............
..............
..............
..............
Level:
Armish
Cigarette kills you...
Bricks:
........k.k.k.
.........k.kk.
..........kk..
..........kk..
...eejjjjj.k..
...eejjjjj....
...#.#.#.#....
..............
..............
..............
..............
..............
..............
..............
..............
..............
..............
..............
Bonus:
..............
..............
..............
..............
..............
..............
..............
..............
..............
..............
..............
..............
..............
..............
..............
..............
..............
..............
Level:
Armish
www.linux-sevenler.de
Bricks:
**************
*............*
*..!!....!!..*
*..!!....!!..*
*............*
*.....!!.....*
*.!...!!...!.*
*.!!......!!.*
*..!!....!!..*
*...!!!!!!...*
*.......!!...*
*.......!!...*
*............*
**************
..............
..............
..............
..............
Bonus:
..............
..............
..............
..............
..............
..............
..............
..............
..............
..............
..............
..............
..............
..............
..............
..............
..............
..............
