Version: 1.00
Level:
Daxter304
Sadistic 1
Bricks:
E#@E#@E#@E#@E#
!!!!!!!!!!!!!!
fffvaaaaaavggg
f*fvaaaaaavg*g
fffvvvvvvvvggg
jjjhhhhiiiikkk
jjjhhhhiiiikkk
jjjhhhhiiiikkk
jjjhhhhiiiikkk
..............
eeeeeeeeeeeeee
d*d*d*d*d*d*d*
..............
..............
..............
..............
..............
..............
Bonus:
..............
..............
..............
..............
..............
..............
..............
..............
..............
..............
..............
..............
..............
..............
..............
..............
..............
..............
Level:
Daxter304
Sadistic 2
Bricks:
eeeeeeeeeeeeee
eeeeeeeeeeeeee
dddddddddddddd
dvcbabccbabcvd
dvcbabccbabcvd
dddddddddddddd
hhhhhhhhhhhhhh
jjjjjjjjjjjjjj
kkkkkkkkkkkkkk
xxxxxxxxxxxxxx
..............
..............
..............
..............
..............
..............
..............
..............
Bonus:
..............
..............
..............
..............
..............
..............
..............
..............
..............
..............
..............
..............
..............
..............
..............
..............
..............
..............
Level:
Daxter304
Sadistic 3
Bricks:
v............v
..............
..............
..............
...EEEEEEEE...
...gggggggg...
v..ggg*gggg..v
...gggg*ggg...
...gggggggg...
...EEEEEEEE...
...E******E...
...EccccccE...
...EvvvvvvE...
...v......v...
..............
..............
..............
..............
Bonus:
..............
..............
..............
..............
..............
..............
..............
..............
..............
..............
..............
..............
..............
..............
..............
..............
..............
..............
Level:
Daxter304
Sadistic 4
Bricks:
##############
**************
!!!!!!!!!!!!!!
#fffff##fffff#
#fffff##fffff#
#fffff##fffff#
#fffff##fffff#
#fffff##fffff#
ffffffffffffff
ffffffffffffff
vvvvvvvvvvvvvv
..............
..............
..............
..............
..............
..............
..............
Bonus:
..............
..............
..............
..............
..............
..............
..............
..............
..............
..............
..............
..............
..............
..............
..............
..............
..............
..............
Level:
Daxter304
Sadistic 5
Bricks:
**************
eeeeeeeeeeeeee
EEEEEE..EEEEEE
vvvvvv..vvvvvv
hhhhhhhhhhhhhh
kkkkkkkkkkkkkk
kkkkkkkkkkkkkk
eeeeeeeeeeeeee
eeeeeeeeeeeeee
..............
..............
..............
..............
..............
..............
..............
..............
..............
Bonus:
..............
..............
..............
..............
..............
..............
..............
..............
..............
..............
..............
..............
..............
..............
..............
..............
..............
..............
Level:
Daxter304
Sadistic Final
Bricks:
**************
!!!!!!!!!!!!!!
!!!!!!!!!!!!!!
!!!!!!!!!!!!!!
**************
vvvvvvvvvvvvvv
dddddddddddddd
dddddddddddddd
dddddddddddddd
dddddddddddddd
......vv......
.....v..v.....
....v....v....
...v......v...
..v........v..
.v..........v.
v............v
vvvvvvvvvvvvvv
Bonus:
..............
..............
..............
..............
..............
..............
..............
..............
..............
..............
..............
..............
..............
..............
..............
..............
..............
..............
