24 48
0 0 0 0 0 0 0 24 6 0 0 7 23 0 0 0 0 0 0 0 0 0 0 0 
0 0 0 0 0 0 24 22 3 0 0 4 21 23 0 0 0 0 0 0 0 0 0 0 
0 0 0 0 0 0 4 17 3 0 0 4 17 3 0 0 0 0 0 0 0 0 0 0 
0 0 0 0 0 24 12 20 3 0 0 4 17 3 0 0 0 0 0 0 0 0 0 0 
0 0 0 0 0 4 17 17 3 0 0 4 17 9 23 0 0 0 0 0 0 0 0 0 
0 0 0 0 24 22 17 18 3 0 0 4 18 17 9 6 0 0 0 0 0 0 0 0 
0 0 0 15 22 17 17 17 3 0 0 4 17 17 17 21 23 0 0 0 0 0 0 0 
0 24 16 17 17 17 20 17 3 0 0 4 17 20 17 17 3 0 0 0 0 0 0 0 
15 22 17 17 18 17 17 17 3 0 0 4 17 17 20 17 21 23 0 0 0 0 0 0 
17 17 20 17 17 17 17 17 3 0 0 8 2 11 17 17 17 21 14 0 0 0 0 0 
17 10 2 2 2 2 2 2 5 0 0 0 0 8 2 2 11 17 17 13 14 0 0 0 
17 3 0 0 0 0 0 0 0 0 0 0 0 0 0 0 8 11 17 17 17 13 14 0 
17 3 0 0 0 0 0 0 0 0 0 0 0 0 0 0 0 8 2 11 17 20 17 13 
20 3 0 0 24 27 28 19 1 19 19 19 1 19 27 6 0 0 0 8 11 17 17 17 
17 3 0 0 4 17 17 20 17 17 17 17 17 18 17 9 6 0 0 0 8 238 11 17 
17 33 116 116 34 17 17 17 17 17 17 17 17 17 17 17 9 6 0 0 0 0 240 17 
17 3 0 0 8 2 2 11 17 18 17 17 17 17 17 17 17 9 6 0 0 0 4 20 
17 3 0 0 0 0 0 8 238 2 238 2 238 11 17 20 17 17 9 6 0 0 4 17 
17 3 0 0 0 0 0 0 0 0 0 0 0 8 11 17 17 17 17 3 0 0 4 17 
17 239 0 0 0 0 0 0 0 0 0 0 0 0 8 11 17 17 17 3 0 0 4 17 
17 3 0 0 0 0 0 0 0 0 0 0 0 0 0 8 11 18 17 3 0 0 4 17 
17 239 0 0 0 0 0 0 0 0 0 0 0 0 0 0 4 17 17 3 0 0 4 17 
17 3 0 0 0 0 0 0 0 0 0 0 0 0 0 0 240 17 17 3 0 0 4 17 
17 239 0 0 0 0 0 0 0 0 0 0 0 0 0 0 4 17 20 3 0 0 4 17 
17 3 0 0 0 0 0 0 0 0 0 0 0 0 0 0 240 17 17 3 0 0 4 20 
17 9 14 0 0 0 0 0 0 0 0 0 0 0 0 0 4 17 17 3 0 0 4 17 
17 17 17 13 23 0 0 0 0 0 0 0 0 0 0 0 240 20 17 3 0 0 4 17 
17 17 20 17 21 237 1 237 1 237 1 23 0 0 0 0 4 17 17 3 0 0 4 17 
20 17 17 17 17 17 17 17 17 20 17 33 116 116 116 116 34 17 17 3 0 0 4 17 
17 10 2 2 2 2 234 2 2 234 234 5 0 0 0 0 4 18 17 235 114 115 236 17 
17 235 82 82 82 82 91 82 82 91 88 0 0 0 0 0 4 17 17 3 0 0 4 17 
17 3 0 0 0 0 0 0 0 0 90 82 93 93 96 0 4 17 17 3 0 0 4 17 
17 3 0 0 0 0 0 0 0 0 81 0 0 0 0 151 40 17 17 3 0 0 4 17 
18 3 0 0 99 98 0 0 0 0 81 0 0 0 0 0 4 17 17 3 0 0 4 17 
17 3 0 0 81 90 114 115 82 82 84 0 0 0 0 0 4 17 18 3 0 0 4 17 
17 3 0 0 81 81 0 0 0 0 0 0 0 0 0 0 4 17 17 3 0 0 4 17 
17 3 0 0 81 81 0 0 0 0 0 211 212 0 0 0 4 17 17 39 77 151 40 20 
17 3 0 0 81 81 0 0 7 1 1 231 232 1 1 1 12 17 17 3 0 0 4 17 
17 3 0 0 90 91 82 82 236 17 20 20 17 17 17 17 17 10 2 5 0 0 4 17 
17 3 0 0 87 82 82 82 236 17 17 17 17 17 18 17 17 3 0 0 0 0 4 17 
17 3 0 0 0 0 0 0 8 234 2 2 2 2 2 2 2 5 0 0 0 0 4 17 
20 3 0 0 0 0 111 0 0 94 0 0 0 0 0 0 0 0 0 0 0 0 4 17 
17 3 0 0 0 0 100 95 82 97 0 0 0 0 0 0 0 0 0 0 0 0 4 17 
17 239 0 0 0 0 0 0 0 0 0 0 0 0 0 0 0 0 0 0 0 15 12 17 
17 3 0 0 0 0 0 0 0 0 0 0 0 0 0 0 0 0 0 15 16 17 17 17 
17 21 1 1 1 1 1 1 1 1 1 1 1 1 1 1 1 1 16 17 17 18 17 17 
18 17 17 17 17 17 17 17 17 20 17 17 17 17 17 17 17 17 17 17 17 17 17 17 
17 17 17 17 17 20 17 17 17 17 17 17 17 17 17 18 17 17 20 17 17 17 17 17 
0 0
14 0
1
11 52 1
0
