40 24
41 41 41 41 41 41 41 41 46 0 0 47 41 46 0 0 47 41 41 41 41 41 41 41 41 41 41 41 41 41 41 41 41 41 41 41 41 41 41 41 
57 57 65 57 57 57 65 57 215 114 115 216 57 215 114 115 216 65 57 57 57 57 57 57 57 57 65 57 65 57 65 57 65 57 57 57 57 65 65 65 
57 50 42 42 42 42 42 68 45 0 0 48 68 45 0 0 48 69 42 42 42 42 42 42 42 42 42 42 42 42 42 42 42 42 42 42 42 42 51 57 
57 43 0 0 0 0 0 0 0 0 0 0 0 0 0 0 0 0 0 0 0 0 0 0 0 0 0 0 0 0 0 0 0 0 0 0 0 0 44 57 
65 199 0 0 0 0 0 0 0 0 0 0 0 0 0 0 0 0 0 0 0 0 0 0 0 0 0 0 0 0 0 0 0 0 0 0 0 0 200 57 
65 199 0 0 0 0 0 0 0 0 0 0 0 0 0 0 0 0 0 0 0 0 0 0 0 0 0 0 0 0 0 0 0 0 0 0 0 0 200 57 
65 43 0 0 0 0 0 0 0 0 0 0 0 223 0 0 0 0 0 0 0 0 0 0 0 209 210 0 0 0 0 0 0 0 0 0 0 0 44 57 
57 61 41 41 41 41 41 41 41 46 0 0 47 224 41 41 41 41 197 41 41 197 41 41 41 229 230 46 0 0 47 41 41 41 41 41 41 41 62 65 
57 50 42 42 42 42 214 42 68 45 0 0 48 69 42 156 42 42 42 51 50 42 214 42 42 214 68 45 0 0 48 69 42 42 42 42 388 42 51 65 
57 43 0 0 0 0 81 0 0 0 0 0 0 0 0 0 0 0 0 176 43 0 81 0 0 81 0 0 0 0 0 0 0 0 0 0 0 0 44 65 
57 43 0 0 0 0 81 0 0 0 0 0 0 0 0 0 0 0 0 44 43 0 94 0 0 81 0 0 0 0 0 0 0 0 0 0 0 0 44 57 
57 215 82 82 82 82 91 82 82 82 82 85 0 0 86 82 89 82 82 216 215 82 91 82 82 91 89 82 82 82 82 82 95 82 85 0 0 0 44 57 
57 43 0 0 0 0 0 0 0 0 0 94 0 0 81 0 81 0 0 44 43 0 0 0 0 0 81 0 0 0 0 0 0 0 81 0 0 0 44 57 
57 43 0 0 0 0 0 0 0 0 0 81 0 0 81 0 81 0 0 44 43 0 0 0 0 0 81 0 0 0 0 0 0 0 81 0 0 0 44 57 
57 43 0 0 0 0 0 0 0 0 0 94 0 0 81 0 81 0 0 44 215 96 0 0 60 82 91 82 82 82 95 82 82 82 97 0 0 0 44 57 
57 215 82 82 82 95 82 95 82 82 82 84 0 0 81 0 81 0 0 44 139 0 0 0 0 0 0 0 0 0 0 0 0 0 0 0 0 0 408 57 
57 43 0 0 0 0 0 0 0 0 0 0 0 0 81 0 81 0 0 44 215 96 0 0 60 82 82 82 82 96 0 60 82 82 98 0 0 0 44 57 
57 43 0 0 0 0 0 0 0 0 0 0 0 0 81 0 81 0 0 44 43 0 0 0 0 0 0 0 0 0 0 0 0 0 92 0 0 0 44 57 
57 175 0 0 0 0 0 99 82 96 0 60 95 82 97 0 81 0 0 44 43 0 0 0 0 0 0 0 0 0 0 0 0 0 92 0 0 0 44 57 
57 43 0 0 0 0 0 81 0 0 0 0 0 0 0 0 90 82 82 216 43 0 0 0 0 0 0 0 0 0 0 0 0 0 92 0 0 0 44 57 
57 43 0 0 0 0 111 81 0 0 0 0 0 0 0 0 81 0 0 44 43 0 0 0 0 0 0 0 0 0 0 0 0 0 92 0 0 0 44 57 
57 43 0 0 0 99 83 88 0 0 0 0 0 0 0 0 81 0 0 44 43 0 0 0 0 0 0 0 0 0 0 0 0 0 92 0 0 0 44 57 
57 49 41 41 41 213 213 213 41 155 155 155 41 41 41 41 213 41 41 62 61 41 41 387 41 41 41 41 41 41 387 41 41 41 213 41 41 41 52 57 
57 57 57 57 57 57 57 57 57 57 57 57 57 57 57 57 57 57 57 57 57 57 57 57 57 57 57 57 57 57 57 57 57 57 57 57 57 57 57 57 
14 0
0 1
0
2
