86 70
106 0 0 0 0 0 0 0 0 0 0 0 0 0 0 0 0 0 0 0 0 0 0 107 101 101 101 106 0 0 0 0 0 0 0 0 0 0 0 0 0 0 0 0 0 0 0 0 0 0 0 0 0 0 0 0 0 0 0 0 0 0 0 0 0 0 0 0 0 0 0 0 0 0 0 0 0 0 0 0 0 0 0 0 0 0 
141 143 0 0 0 0 0 0 107 101 101 101 101 143 0 0 0 0 0 0 0 0 0 104 127 127 127 109 143 0 0 0 0 0 0 0 144 101 143 0 0 0 0 0 0 0 0 0 0 0 0 0 0 0 0 0 0 0 0 0 0 0 0 0 0 0 0 0 0 0 0 0 0 0 0 0 0 0 0 0 0 0 0 0 0 0 
127 141 106 0 0 0 0 107 122 127 127 127 127 141 143 0 0 107 101 101 101 101 101 122 127 128 127 127 109 143 0 0 0 0 0 144 122 127 141 143 0 0 0 0 0 0 0 0 0 0 0 0 0 0 0 0 0 0 0 0 0 0 0 0 0 0 0 0 0 0 0 0 0 0 0 0 0 0 0 0 0 0 0 0 0 0 
127 127 103 0 0 0 0 104 127 127 127 128 127 127 141 101 101 122 127 127 127 127 127 127 127 127 127 127 127 109 101 101 207 208 101 122 127 127 127 141 143 0 0 0 0 0 0 0 0 0 0 0 0 0 0 0 0 0 0 0 0 0 0 0 0 0 0 0 0 0 0 0 0 0 0 0 0 0 0 0 0 0 0 0 0 0 
128 127 195 82 114 115 132 196 127 127 127 127 127 127 127 127 127 127 127 127 127 127 127 127 127 127 127 127 127 127 127 127 227 228 127 127 128 127 127 127 103 0 0 0 0 0 0 0 0 0 0 0 0 0 0 0 0 0 0 0 0 0 0 0 0 0 0 0 144 143 0 0 0 0 0 0 0 0 0 0 0 0 0 0 0 0 
127 127 103 0 0 0 0 104 127 127 127 127 127 127 127 127 127 128 127 127 127 127 127 127 127 127 127 127 127 127 127 127 127 127 127 127 127 127 127 127 109 106 0 0 0 0 0 0 0 0 0 0 0 0 0 0 0 0 0 0 0 0 0 0 0 0 0 107 142 141 143 0 0 0 0 0 0 0 0 0 0 0 0 0 0 0 
127 127 103 0 0 0 0 108 102 102 102 102 102 178 121 127 127 127 127 127 127 127 127 127 127 127 127 127 128 127 127 127 127 127 127 127 127 127 127 127 127 141 143 0 0 0 0 0 0 0 0 0 0 0 0 0 0 0 0 0 0 0 0 0 0 0 107 142 127 127 109 106 0 0 0 0 0 0 0 0 0 0 0 0 0 0 
127 127 179 0 0 0 0 0 0 0 0 0 0 0 108 102 178 121 127 127 127 127 127 127 127 127 127 127 127 127 127 127 128 127 127 127 127 127 127 128 127 127 141 143 0 0 0 0 0 0 0 0 0 0 0 0 0 0 0 0 0 0 0 0 0 144 122 127 128 127 127 109 143 0 0 0 0 0 0 0 0 0 0 0 0 0 
127 127 109 101 101 106 0 0 0 0 0 0 0 0 0 0 0 104 127 127 127 127 127 127 127 127 127 127 110 102 194 102 102 178 121 127 110 121 127 127 127 127 127 141 106 0 0 0 0 0 0 0 0 144 143 0 0 0 0 0 0 0 144 101 101 142 127 127 127 127 127 127 109 106 0 0 0 0 0 0 0 0 0 0 0 0 
127 127 127 127 127 103 0 0 0 0 0 0 0 0 0 0 0 108 121 127 127 127 127 127 127 127 127 127 195 82 83 85 0 0 108 118 105 104 127 127 127 127 127 127 141 143 0 0 0 0 0 0 107 122 109 143 0 0 0 0 0 144 142 127 127 127 127 127 127 128 128 127 127 109 143 0 0 0 0 0 0 0 0 0 0 0 
127 127 127 127 127 179 0 0 0 0 0 0 0 0 0 0 0 0 104 127 127 127 127 127 127 127 127 127 109 106 133 134 0 0 0 0 0 180 127 127 127 127 128 128 127 141 106 0 0 0 0 0 104 128 127 109 106 0 0 0 0 104 127 127 128 127 127 127 127 127 127 127 127 127 141 143 0 0 0 0 0 0 0 0 0 0 
127 127 127 127 127 109 101 101 129 129 101 106 0 0 0 0 0 0 180 127 127 127 127 127 127 127 127 127 127 103 135 136 0 0 0 0 107 122 127 127 127 127 127 127 127 127 109 101 101 101 101 101 122 127 127 127 109 101 101 101 101 122 127 127 127 127 127 127 127 127 127 127 127 127 127 109 106 0 0 0 0 0 0 0 0 0 
127 127 127 127 127 127 127 127 127 127 127 109 106 0 0 111 0 0 104 127 127 127 127 127 127 127 127 127 110 105 81 81 0 0 0 0 104 127 127 127 127 127 127 127 127 127 127 127 127 127 127 127 127 127 127 127 127 127 127 127 127 127 127 127 127 127 127 127 127 127 127 127 127 127 127 127 141 143 0 0 0 0 0 0 0 0 
127 127 127 127 127 127 127 127 127 127 127 127 103 0 0 81 0 0 104 127 127 127 127 127 127 127 127 127 195 82 91 88 0 0 0 0 104 127 127 127 127 127 127 127 127 127 127 127 127 127 128 127 127 127 127 127 127 127 127 127 127 127 127 127 127 127 127 127 127 127 127 127 127 127 128 127 127 109 101 101 106 0 0 0 0 0 
127 127 127 127 127 127 127 127 127 127 127 127 103 0 0 81 0 0 104 127 127 127 127 127 127 127 127 127 109 106 47 213 46 0 0 0 104 127 127 127 127 127 127 127 127 127 127 127 127 127 127 127 127 127 127 127 127 127 127 127 127 127 127 127 127 127 127 127 127 127 127 127 127 127 127 127 127 127 127 127 103 0 0 0 0 0 
127 127 127 127 127 127 127 127 127 127 127 127 103 0 0 87 82 82 196 127 127 127 127 127 127 127 127 127 127 103 44 65 407 0 0 0 180 127 127 127 127 127 127 127 127 127 127 127 127 127 127 127 127 127 127 127 127 127 127 127 127 127 127 127 127 127 127 127 127 127 127 127 127 127 127 127 127 127 127 127 103 0 0 0 0 0 
127 127 127 127 127 127 127 127 127 127 127 127 103 0 0 0 0 0 104 127 127 127 127 127 127 127 127 127 127 103 48 156 45 0 0 0 104 127 127 127 127 127 127 127 127 127 127 127 127 127 127 127 127 127 127 127 127 127 127 127 127 127 127 127 127 127 127 127 127 127 127 127 127 127 127 127 127 127 127 127 103 0 0 0 0 0 
127 127 127 127 127 127 127 127 127 127 127 127 103 0 0 0 0 0 104 127 127 127 127 127 127 127 127 127 127 103 0 0 0 0 0 0 104 127 127 127 127 127 127 127 127 127 127 127 127 127 127 127 127 127 127 127 127 127 127 127 127 127 127 127 127 127 127 127 127 127 127 127 127 127 127 127 127 127 127 127 103 0 0 0 0 0 
127 127 127 127 127 127 127 127 127 127 127 127 195 82 114 115 82 82 196 127 127 127 127 127 127 127 127 127 127 103 0 0 0 0 0 0 104 127 127 127 127 127 127 127 127 127 127 127 127 127 127 127 127 127 127 127 127 127 127 127 127 127 127 127 127 127 127 127 127 127 127 127 127 127 127 127 127 127 127 127 103 0 0 0 0 0 
127 127 127 127 127 127 127 127 127 127 127 127 103 0 0 0 0 0 104 127 127 127 127 127 127 127 127 127 127 179 0 0 0 0 0 0 180 127 127 127 127 127 127 127 127 127 127 127 127 127 127 127 127 127 127 127 127 127 127 127 127 127 127 127 127 127 127 127 127 127 127 127 127 127 127 127 127 127 127 127 103 0 0 144 143 0 
127 127 127 127 127 127 110 102 102 102 178 178 105 0 0 0 0 0 108 178 178 102 102 102 121 127 127 127 127 103 0 0 0 0 0 0 104 127 127 127 127 127 127 127 127 127 127 127 127 127 127 127 127 127 127 127 127 127 127 127 127 127 127 127 127 127 127 127 127 127 127 127 127 127 127 127 127 127 127 127 103 0 144 142 141 143 
127 127 127 127 127 127 103 0 0 0 0 0 0 0 0 0 0 0 0 0 0 0 0 0 104 127 127 127 127 103 0 0 0 0 0 0 104 127 127 127 127 127 127 127 127 127 127 127 127 127 127 127 127 127 127 127 127 127 127 127 127 127 127 127 127 127 127 127 127 127 127 127 127 127 127 127 127 127 127 128 103 0 104 128 127 141 
127 127 110 102 102 102 105 0 0 0 0 0 0 0 0 0 0 0 0 0 0 0 0 0 108 121 127 127 127 103 0 0 0 0 0 0 104 127 127 127 127 127 127 127 127 127 127 127 127 127 127 127 127 127 127 127 127 127 127 127 127 127 127 127 127 127 127 127 127 127 127 127 127 127 127 127 127 127 127 127 103 0 104 127 127 127 
127 127 103 0 0 0 0 0 0 0 0 0 0 0 0 0 0 0 0 0 0 0 0 0 0 104 127 127 127 179 0 0 0 0 0 0 180 127 127 127 127 127 127 127 127 127 127 127 127 127 127 127 127 127 127 127 127 127 127 127 127 127 127 127 127 127 127 127 127 127 127 127 127 127 127 127 127 127 127 127 103 0 104 127 127 127 
127 127 103 0 0 0 0 0 0 0 0 0 0 0 0 0 0 0 0 0 0 0 0 0 0 104 127 127 127 103 0 0 0 0 0 0 104 127 127 127 127 127 127 127 127 127 127 127 127 127 127 127 127 127 127 127 127 127 127 127 127 127 127 127 127 127 127 127 127 127 127 127 127 127 127 127 127 127 127 127 103 0 104 127 128 127 
127 127 103 0 0 0 0 0 0 0 0 0 0 0 0 0 0 0 0 0 0 0 0 0 0 104 127 127 127 103 0 0 0 0 0 0 104 127 127 127 127 127 127 127 127 127 127 127 127 127 127 127 127 127 127 127 127 127 127 127 127 127 127 127 127 127 127 127 127 127 127 127 127 127 127 127 127 127 127 127 103 0 104 127 127 127 
127 127 163 116 116 116 116 116 116 116 116 116 116 116 116 116 116 116 116 116 116 116 116 116 116 164 127 127 127 103 0 0 0 0 0 0 104 127 127 127 127 110 102 102 102 102 102 102 102 102 102 102 102 102 102 102 102 178 121 127 127 127 127 127 127 127 127 127 127 127 127 127 127 127 127 127 127 127 127 127 103 0 104 127 128 127 
127 127 103 0 0 0 0 0 0 0 0 0 0 0 0 0 0 0 0 0 0 0 0 0 0 104 127 127 127 179 0 0 0 0 0 0 180 127 127 127 110 105 0 0 0 0 0 0 0 0 0 0 0 0 0 0 0 0 108 102 102 102 102 178 121 127 127 127 127 127 127 127 127 127 127 127 127 127 127 127 103 0 104 127 127 127 
127 127 103 0 47 155 46 0 0 0 0 0 0 0 0 0 0 0 0 0 0 0 47 155 46 104 127 127 127 103 0 0 0 0 0 0 104 127 127 127 103 0 0 0 0 0 0 0 0 0 0 0 0 0 0 0 0 0 0 0 0 0 0 0 108 102 102 102 102 102 102 102 102 102 121 127 127 127 127 127 103 0 104 127 127 127 
127 127 195 82 216 57 219 0 0 0 0 0 0 0 0 0 0 0 0 0 0 0 220 57 215 196 127 127 127 103 0 0 0 0 0 0 104 127 127 127 103 0 0 0 0 0 0 0 0 0 0 0 0 0 0 0 0 0 0 0 0 0 0 0 0 0 0 0 0 0 0 0 0 0 180 127 127 127 127 127 103 0 104 127 127 127 
127 127 195 82 216 57 407 0 0 0 0 0 0 0 0 0 0 0 0 0 0 0 408 57 215 196 127 127 127 103 0 0 0 0 0 0 104 127 127 127 103 0 0 0 0 0 0 0 0 0 0 0 0 0 0 0 0 0 0 0 0 0 0 0 0 0 0 0 0 0 0 0 0 0 104 127 127 127 127 128 103 0 104 127 127 127 
127 127 109 106 48 156 45 0 0 0 0 0 0 0 0 0 0 0 0 0 0 0 48 156 45 104 127 127 127 179 0 0 0 0 0 0 180 127 127 127 103 0 0 0 0 0 0 0 0 0 0 0 0 0 0 0 0 0 0 0 0 0 0 0 0 0 0 0 0 0 0 0 0 0 104 127 127 127 127 128 103 0 104 127 127 127 
127 127 127 103 0 0 0 0 0 0 0 0 0 0 0 0 0 0 0 0 0 0 0 0 0 104 127 127 127 103 0 0 0 0 0 0 104 127 127 127 109 106 0 0 0 0 0 0 0 0 150 0 0 0 0 0 0 0 0 0 0 0 0 0 0 0 0 0 0 0 150 0 0 0 104 127 128 127 127 127 103 0 104 127 127 127 
127 127 127 163 116 116 116 116 116 116 116 116 116 116 116 116 116 116 116 116 116 116 116 116 116 164 127 127 127 103 0 0 0 0 0 0 104 127 127 127 127 109 101 101 106 0 0 0 0 107 193 101 101 101 101 101 101 101 101 101 101 101 101 101 101 101 101 101 101 101 193 106 0 0 104 127 128 127 127 127 103 0 104 127 127 127 
127 127 127 103 47 41 46 0 0 0 0 0 0 0 0 0 0 0 0 0 0 0 47 41 46 104 127 127 127 103 0 0 0 0 0 0 104 127 127 127 127 127 127 127 103 0 0 0 0 104 127 127 127 127 127 127 127 127 127 127 127 127 127 127 127 127 127 127 127 127 127 109 106 0 104 127 127 127 128 127 103 0 104 127 127 127 
127 127 127 195 216 57 199 0 0 0 0 0 0 0 0 0 0 0 0 0 0 0 200 57 215 196 127 127 127 103 0 0 0 0 0 0 104 127 127 127 127 127 127 127 195 82 114 115 82 196 127 127 127 127 127 127 127 127 127 127 127 127 127 127 127 127 127 127 127 127 127 127 103 0 104 127 127 127 127 127 103 0 104 127 127 127 
127 127 127 103 48 156 45 0 0 0 0 0 0 0 0 0 0 0 0 0 0 0 48 156 45 104 127 127 127 103 0 0 0 0 0 0 104 127 127 127 127 127 127 127 103 0 0 0 0 104 127 127 127 127 127 127 127 127 127 127 127 127 127 127 127 127 127 127 127 127 127 127 103 0 104 127 127 127 127 127 103 0 104 128 127 127 
127 127 127 163 116 116 116 116 116 116 116 116 116 116 116 116 116 116 116 116 116 116 116 116 116 164 127 127 127 103 0 0 0 0 0 0 108 102 102 102 102 102 102 102 105 0 0 0 0 104 127 127 127 127 127 127 127 127 127 127 127 127 127 127 127 127 127 127 127 127 127 127 103 0 108 121 127 127 127 127 103 0 104 127 127 127 
127 127 127 103 0 0 0 0 0 0 0 0 0 0 0 0 0 0 0 0 0 0 0 0 0 104 127 127 127 103 0 0 0 0 0 0 0 0 0 0 0 0 0 0 0 0 0 0 0 104 127 127 127 127 127 127 127 127 127 127 127 127 127 127 127 127 127 127 127 127 127 127 103 0 0 104 127 127 127 127 103 0 104 127 127 127 
127 127 127 179 0 0 0 0 0 0 0 0 0 0 0 0 0 0 0 0 0 0 0 0 0 180 127 127 127 103 0 0 0 0 0 0 0 0 0 0 0 0 0 0 0 0 0 0 0 104 127 127 127 127 127 127 127 127 127 127 127 127 127 127 127 127 127 127 127 127 127 127 103 0 0 104 127 127 128 127 103 0 104 127 127 127 
127 127 127 103 0 0 0 0 0 0 0 0 0 0 0 0 0 0 0 0 0 0 0 0 107 122 127 127 127 109 101 177 101 177 101 101 101 106 0 107 101 101 101 101 101 101 101 101 101 122 127 127 127 127 127 127 127 127 127 127 127 127 127 127 127 127 127 127 127 127 127 127 169 77 0 104 127 127 127 127 103 0 104 127 127 127 
127 127 127 109 101 101 101 101 101 101 177 177 106 0 0 0 0 0 0 107 177 177 101 101 122 127 127 127 127 127 127 127 127 127 127 128 127 103 0 104 127 127 127 127 127 127 127 127 127 127 127 127 127 127 127 127 127 127 127 127 127 127 127 127 127 127 127 127 127 127 127 127 103 0 0 104 127 127 127 127 103 0 104 127 127 127 
127 127 127 127 127 128 127 127 127 127 127 127 103 0 0 0 0 0 107 122 127 127 127 127 127 127 127 127 127 127 128 127 127 127 127 127 127 103 0 104 128 127 127 127 128 127 127 127 127 127 127 127 127 127 127 127 127 127 127 127 127 127 127 127 127 127 127 127 127 127 127 127 103 0 151 170 127 127 127 127 103 0 104 127 127 127 
127 127 127 127 127 127 127 127 127 127 127 127 103 0 0 0 0 0 104 127 128 127 127 128 127 127 127 127 127 127 127 127 127 127 127 128 127 103 0 104 127 127 127 127 127 127 127 127 127 127 127 127 127 127 127 127 127 127 127 127 127 127 127 127 127 127 127 127 127 127 127 127 103 0 0 104 127 127 127 127 103 0 104 127 127 127 
127 127 127 127 127 127 127 127 127 127 128 127 103 0 0 0 0 0 104 127 127 127 127 127 127 127 127 127 127 127 127 127 127 127 127 127 127 103 0 104 127 127 127 127 127 127 110 102 102 102 102 178 102 102 102 102 102 102 178 178 102 102 102 102 102 102 178 121 127 127 127 127 103 0 0 104 127 127 127 128 103 0 104 127 127 127 
127 127 127 127 127 127 127 127 127 127 128 127 163 116 116 116 116 116 164 127 127 127 127 127 127 127 127 127 127 127 127 110 102 102 102 102 102 105 0 104 127 127 127 127 127 110 105 0 0 0 0 0 0 0 0 0 0 0 0 0 0 0 0 0 0 0 0 108 102 102 102 178 105 0 0 104 127 127 127 127 103 0 104 127 127 128 
127 127 127 127 127 127 127 127 127 127 127 127 103 0 0 0 0 0 104 127 127 127 127 127 127 127 127 127 127 127 127 103 0 0 0 0 0 0 0 104 127 127 127 127 110 105 0 0 0 0 0 0 0 0 0 0 0 0 0 0 0 0 0 0 0 0 0 0 0 0 0 0 0 0 0 104 127 127 127 127 103 0 104 127 127 127 
127 127 127 127 127 127 127 127 110 102 102 102 105 0 0 0 0 0 104 127 128 127 127 127 127 127 127 127 127 127 127 103 0 107 147 101 101 225 226 122 127 127 127 127 103 0 0 0 0 0 0 0 0 0 0 0 0 0 0 0 0 0 0 0 0 0 0 0 0 0 0 0 0 0 0 104 127 127 127 127 103 0 104 127 127 127 
127 127 127 110 102 102 102 102 105 0 0 0 0 0 0 0 0 0 104 127 127 127 127 127 128 127 127 127 127 127 127 103 0 104 127 128 127 127 127 127 127 127 127 127 103 0 0 0 0 0 0 0 0 0 0 0 0 0 0 0 0 0 0 0 0 0 0 0 0 0 0 0 0 0 0 104 127 128 127 127 103 0 104 127 127 127 
127 127 127 179 0 0 0 0 0 0 0 0 0 0 0 0 0 0 104 127 127 127 127 127 127 127 127 127 128 127 127 103 0 104 127 127 127 127 127 127 127 127 127 128 179 0 0 0 0 0 0 0 0 0 0 0 0 0 0 0 0 0 0 0 0 0 0 0 0 0 0 0 0 0 0 104 127 127 127 127 103 0 104 128 127 127 
127 127 127 179 0 0 0 0 0 0 0 0 0 0 0 0 0 107 122 127 127 127 127 127 127 127 127 127 127 127 127 103 0 104 127 127 127 127 127 127 127 127 127 127 103 0 0 0 0 0 0 0 0 0 0 0 0 0 0 0 0 0 0 0 0 0 0 0 0 0 0 0 0 0 0 104 127 127 128 127 103 0 104 127 127 127 
127 127 127 103 0 107 101 101 101 101 101 101 101 101 101 101 101 122 127 127 127 127 127 127 127 127 127 127 127 127 127 103 0 104 127 127 127 127 127 127 127 127 127 127 103 0 0 0 0 0 0 0 0 0 0 0 0 0 0 0 0 0 0 0 0 0 0 0 0 0 0 0 0 0 0 104 127 127 127 127 103 0 104 127 127 127 
127 127 127 103 0 104 128 127 127 127 127 127 127 127 127 128 127 127 128 127 127 127 127 110 102 102 102 102 102 102 102 105 0 104 128 127 127 127 127 127 127 127 127 127 179 0 0 0 0 0 0 0 0 0 0 0 0 0 0 0 0 0 0 0 0 0 0 0 0 0 0 0 0 0 125 142 127 127 127 127 103 0 104 127 127 127 
127 127 127 169 77 104 127 127 127 127 127 127 127 127 127 127 127 127 127 127 127 127 127 103 0 0 0 0 0 0 0 0 125 142 127 127 127 127 127 127 127 127 127 127 103 0 0 0 150 0 0 0 0 0 0 0 0 0 0 0 0 0 0 0 0 0 0 0 0 0 0 0 125 126 127 127 127 127 127 127 103 0 104 127 127 127 
127 127 127 103 0 104 127 127 127 127 127 127 127 127 127 127 127 127 127 127 127 127 127 103 0 107 101 101 101 101 101 126 127 127 127 127 127 127 127 127 127 127 127 127 103 0 0 107 193 101 101 101 101 101 101 101 101 101 101 101 101 101 101 101 101 101 101 101 101 101 101 126 127 128 127 127 127 127 127 127 103 0 104 127 127 127 
127 127 127 103 0 104 127 127 127 128 128 127 128 127 127 127 127 127 127 127 127 127 127 103 0 104 128 128 127 127 127 127 127 127 127 127 127 127 127 127 127 127 127 127 103 0 0 104 127 127 127 127 127 127 127 127 128 127 127 127 127 127 127 127 127 127 127 127 128 127 127 127 127 127 127 127 127 127 127 127 103 0 104 127 127 127 
127 127 127 103 0 108 102 102 102 102 102 102 102 102 121 127 127 127 127 127 127 127 127 103 0 104 127 127 127 127 127 127 127 127 127 127 127 127 127 127 127 127 127 128 103 0 0 104 127 127 128 127 127 127 127 127 127 127 127 127 127 127 127 127 127 127 127 127 127 127 127 127 127 127 127 127 128 127 127 127 103 0 104 127 127 127 
127 127 127 103 0 0 0 0 0 0 0 0 0 0 104 127 128 127 127 127 127 127 127 103 0 104 127 127 127 127 127 127 128 127 127 127 127 127 127 127 127 127 127 128 103 0 0 104 127 127 127 127 127 127 127 127 127 127 127 127 127 127 127 128 127 127 127 127 127 127 127 127 127 127 127 127 127 127 127 127 103 0 104 128 127 127 
127 127 127 109 101 101 147 101 101 101 101 147 106 0 104 127 127 127 127 127 127 127 127 103 0 104 127 127 127 127 127 127 127 127 127 127 127 127 127 127 127 127 127 127 103 0 0 104 127 127 127 127 127 127 127 127 127 127 127 127 127 127 127 127 127 127 127 127 127 127 127 127 127 127 127 127 127 127 127 127 103 0 104 127 127 127 
127 127 127 127 127 127 128 127 127 127 127 127 103 0 104 127 127 127 127 127 127 127 127 103 0 104 128 127 127 127 127 127 127 127 127 127 127 127 127 127 127 127 127 127 103 0 0 104 128 127 127 127 127 127 127 127 127 127 127 127 127 127 127 127 127 127 127 127 127 127 127 127 127 127 127 127 127 127 127 127 103 0 104 127 127 127 
127 127 127 127 127 127 127 127 127 127 127 127 103 0 104 127 127 127 127 127 127 127 127 103 0 104 127 127 127 127 127 127 127 127 127 127 127 127 127 127 127 127 127 127 103 0 0 104 127 127 127 127 127 127 127 127 127 128 127 127 127 127 127 127 127 127 127 127 127 127 127 127 127 127 127 127 127 127 128 127 103 0 104 127 127 127 
127 127 127 127 127 127 127 127 127 127 127 127 103 0 104 128 127 127 127 127 127 127 127 103 0 104 127 127 127 127 127 127 127 127 127 127 127 127 127 127 127 128 127 127 103 0 0 104 127 127 127 127 127 127 127 127 127 127 127 127 127 127 127 127 127 127 127 127 127 127 128 127 127 127 127 127 127 127 127 127 103 0 104 127 127 127 
127 127 127 127 127 127 127 127 127 127 127 127 103 0 104 127 127 127 127 127 127 127 127 103 0 104 127 127 127 127 127 127 127 127 127 127 127 127 127 127 127 127 127 127 103 0 0 104 127 127 127 127 128 127 127 127 127 127 127 127 127 128 127 127 127 127 127 127 127 127 127 127 127 128 127 127 127 127 127 127 103 0 104 127 127 127 
127 127 127 127 127 127 127 127 127 127 127 128 103 0 104 127 127 127 127 127 127 127 127 103 0 104 127 127 127 128 127 127 127 127 127 127 127 127 127 127 127 127 127 127 103 0 0 108 102 102 102 102 102 102 102 102 102 102 102 102 102 102 102 102 102 102 102 102 102 102 102 102 102 102 102 102 102 102 102 102 105 0 104 127 128 127 
127 127 127 127 127 127 127 127 127 127 127 127 103 0 108 102 102 102 102 102 102 102 102 105 0 104 127 127 127 127 127 127 127 127 127 127 127 127 127 127 127 127 127 127 103 0 0 0 0 0 0 0 0 0 0 0 0 0 0 0 0 0 0 0 0 0 0 0 0 0 0 0 0 0 0 0 0 0 0 0 0 0 104 127 127 127 
127 127 127 127 127 127 127 127 127 127 127 127 103 0 0 0 0 0 0 0 0 0 0 0 151 170 127 127 127 127 127 127 127 127 127 127 127 127 127 127 127 127 127 127 109 101 177 101 101 101 101 101 101 101 101 101 101 101 101 101 101 101 101 101 101 101 101 101 101 101 101 101 101 101 101 101 101 101 101 101 101 101 122 127 127 127 
127 127 127 127 127 127 127 127 127 127 127 127 109 177 101 101 101 101 101 101 101 101 101 101 101 122 127 127 127 127 127 127 127 127 127 127 127 127 127 127 127 127 128 127 127 127 127 127 127 127 127 127 127 127 127 127 127 127 127 127 127 127 127 127 127 127 127 127 127 127 127 127 127 127 127 127 127 127 128 127 127 127 127 127 127 127 
127 127 127 127 127 127 127 127 127 127 127 127 127 127 127 127 127 127 127 127 128 127 127 127 127 127 127 127 127 127 127 127 127 127 127 127 127 127 127 127 127 127 127 127 127 127 127 127 128 127 128 127 127 127 127 127 127 127 127 127 127 127 127 127 127 127 127 127 127 127 127 127 128 127 127 127 127 127 127 127 127 127 127 127 128 127 
127 127 127 127 127 127 127 127 127 127 127 127 127 127 127 128 127 127 127 127 127 127 127 127 127 127 127 127 127 127 127 127 127 127 127 127 127 127 127 127 127 127 127 127 127 127 127 127 127 127 127 127 127 127 127 127 127 127 127 127 127 127 127 127 127 127 127 127 127 127 127 127 127 127 127 127 127 127 127 127 127 127 127 127 127 127 
127 127 127 127 127 127 127 127 127 127 127 127 127 127 127 127 127 127 127 127 127 127 127 127 127 127 127 127 127 127 127 127 127 127 127 127 127 127 127 127 127 127 127 127 127 127 127 127 127 127 127 127 127 127 127 127 127 127 127 127 127 127 127 127 127 127 127 127 127 127 127 127 127 127 127 127 127 127 127 127 127 127 127 127 127 127 
14 0
0 0
0 1
2
58 40 3
58 61 3
1
