48 16
0 0 0 7 1 28 1 1 27 1 1 19 19 19 19 1 1 1 27 1 1 1 1 1 1 19 1 1 1 1 1 1 19 27 1 1 1 27 1 1 1 19 1 1 19 1 19 1 
0 0 0 4 17 17 17 17 17 17 17 18 17 17 17 17 18 17 17 17 17 17 17 17 17 17 20 17 17 17 17 17 17 17 17 17 17 17 17 17 17 17 17 17 17 17 17 17 
0 0 0 8 2 2 2 2 38 238 2 2 2 2 2 2 2 2 2 2 2 2 2 2 2 2 2 2 38 2 2 2 2 2 11 17 17 18 17 17 20 10 2 2 2 11 17 20 
0 0 0 0 0 0 0 0 131 0 0 0 0 0 0 0 0 0 0 0 0 0 0 0 0 0 0 0 131 0 0 0 0 0 4 17 17 18 17 17 17 3 0 0 0 8 11 17 
0 0 0 0 0 0 0 0 131 0 0 0 0 0 0 0 0 0 0 24 1 1 1 1 6 0 0 0 131 0 0 0 0 0 240 17 20 17 17 17 17 3 0 0 0 0 240 17 
0 0 0 0 0 0 0 0 131 0 0 0 0 0 0 0 7 1 1 22 17 17 20 17 3 0 0 0 131 0 0 0 0 0 240 17 17 17 17 17 10 5 0 0 0 111 4 17 
0 0 0 0 0 0 0 0 131 0 0 0 0 0 0 0 240 17 18 17 17 10 2 2 5 0 0 0 131 0 0 0 0 7 12 17 17 17 18 17 3 0 0 0 0 100 236 17 
0 0 0 0 0 0 0 0 131 0 0 0 0 0 0 7 12 17 17 17 17 3 0 0 0 0 7 1 37 19 1 27 1 22 17 18 17 17 17 17 3 0 0 0 0 0 4 17 
0 0 0 0 0 0 0 0 131 0 0 0 0 0 0 4 17 17 10 2 2 5 0 0 0 24 12 17 17 20 17 17 17 20 17 17 17 17 17 17 3 0 0 0 0 0 4 17 
0 0 0 0 0 0 0 0 131 0 0 0 0 0 0 4 20 17 3 0 0 0 0 0 0 8 2 2 2 2 2 11 17 17 10 2 2 2 2 2 5 0 0 0 0 0 4 20 
0 24 1 23 0 0 0 0 131 0 0 0 0 0 0 4 20 17 235 82 95 85 0 0 0 0 0 0 0 0 0 8 2 2 5 0 0 0 0 0 0 0 0 0 0 7 12 17 
19 12 17 9 6 0 0 0 131 0 0 0 0 0 24 12 20 10 5 0 0 81 0 0 0 0 0 0 0 0 0 0 0 0 0 0 0 0 0 0 0 0 0 0 7 12 17 17 
20 17 17 17 9 237 6 0 131 0 0 0 0 7 12 17 17 3 0 0 0 92 0 0 0 0 0 0 0 0 0 0 0 0 0 0 0 0 0 0 0 0 0 0 4 17 17 17 
17 17 18 17 17 17 21 1 37 1 1 1 1 12 17 17 10 5 0 0 7 233 1 1 1 1 1 1 14 0 0 0 0 0 0 0 0 0 0 0 0 0 0 0 4 17 18 17 
17 17 17 17 17 18 17 17 17 17 17 20 17 17 17 17 9 19 19 19 12 17 17 20 17 17 17 17 17 13 1 1 1 1 1 1 1 1 1 1 1 1 1 1 12 17 17 17 
17 17 17 17 17 17 17 17 17 17 17 17 17 17 17 17 17 17 17 17 17 17 17 17 17 17 17 17 17 17 17 17 17 17 17 17 17 17 17 17 17 17 17 17 17 17 17 17 
1
37 21 1
0
