24 16
0 0 0 0 0 0 0 0 0 0 0 0 0 0 0 0 0 0 0 0 0 0 0 0 
0 0 0 0 0 0 0 0 211 212 0 0 0 0 0 0 0 0 0 0 0 0 0 0 
41 41 41 46 0 7 28 1 231 232 23 0 0 0 0 0 0 0 0 7 1 1 19 1 
57 50 42 45 0 8 2 11 20 17 3 47 41 41 41 41 41 46 0 4 17 17 17 17 
57 175 0 0 0 0 0 8 2 11 235 216 57 65 57 65 57 215 95 236 17 17 17 17 
57 43 0 0 0 0 0 0 0 8 5 48 156 42 156 42 156 45 0 8 11 17 17 17 
57 175 0 0 0 0 0 0 0 0 0 0 0 0 0 0 0 0 0 0 8 2 11 17 
57 43 0 0 0 0 0 0 0 0 0 0 0 0 0 0 0 0 0 0 0 0 4 17 
57 175 0 0 0 0 0 0 0 0 0 0 0 0 0 0 0 0 0 0 0 0 4 18 
57 49 41 155 46 0 0 0 0 0 0 0 0 0 0 0 0 0 0 0 0 0 4 17 
57 57 57 57 43 0 0 0 0 0 0 0 47 155 41 155 46 0 0 0 0 0 4 17 
57 57 65 57 49 41 155 41 155 41 155 41 62 57 57 57 43 0 0 0 111 0 8 11 
57 57 57 57 57 57 57 57 57 57 57 57 57 57 65 57 61 73 6 0 92 0 0 4 
75 75 75 75 75 75 75 75 75 75 75 75 75 75 75 75 75 76 21 6 81 0 0 4 
17 17 17 18 17 17 17 17 17 18 17 17 17 17 17 17 17 17 17 21 233 1 1 12 
17 17 17 17 17 17 17 17 17 17 17 17 17 17 17 17 17 17 18 17 17 17 17 17 

0

0