24 24
41 41 41 46 0 0 47 41 41 41 41 41 41 41 41 41 41 46 0 0 47 41 41 41 
57 57 57 215 114 115 216 57 65 65 57 57 57 57 65 65 57 215 114 115 216 57 57 57 
57 50 68 45 0 0 44 57 65 65 57 57 57 57 65 65 57 43 0 0 48 69 51 57 
57 43 0 0 0 0 44 57 65 65 57 57 57 57 65 65 57 43 0 0 0 0 44 57 
57 43 0 0 0 0 44 57 65 65 57 57 57 57 65 65 57 43 0 0 0 0 44 57 
57 43 0 0 0 0 44 57 65 65 57 57 57 57 65 65 57 43 0 0 0 0 44 57 
57 43 0 0 0 0 48 42 42 42 214 214 42 42 42 42 42 45 0 0 0 0 44 57 
57 43 111 0 0 0 0 0 0 0 133 134 0 0 0 0 0 0 0 0 0 0 200 57 
57 43 94 0 0 0 0 0 0 0 135 136 0 0 0 0 0 0 0 0 0 0 200 57 
57 49 213 41 46 0 47 41 41 41 213 213 41 41 41 41 41 41 41 41 41 41 52 57 
57 57 57 57 43 0 44 57 57 57 57 57 57 57 57 57 57 57 57 57 57 57 57 57 
57 57 65 57 43 0 44 57 57 57 57 57 57 57 57 57 57 57 57 57 57 57 57 57 
57 57 57 57 43 0 48 42 156 42 156 42 156 42 156 42 156 42 156 42 156 42 42 51 
57 57 65 57 175 0 0 0 0 0 0 0 0 0 0 0 0 0 0 0 0 0 0 44 
57 57 57 57 43 0 0 0 0 0 0 0 0 0 0 0 0 0 0 0 0 0 0 44 
57 57 65 57 175 0 0 0 0 0 0 0 0 0 0 0 0 0 0 0 0 0 0 44 
57 57 57 57 43 0 0 0 0 0 0 0 0 0 0 0 0 0 0 0 0 0 0 44 
57 57 65 57 175 0 0 0 0 0 0 0 0 0 0 0 0 0 0 0 0 0 0 44 
57 57 57 57 43 0 0 0 0 0 0 0 0 0 0 0 0 0 0 0 0 0 0 44 
57 57 65 57 175 0 0 0 0 0 0 0 0 0 0 0 0 0 0 0 0 0 0 44 
57 57 57 57 43 0 0 0 0 0 0 0 0 0 0 0 0 0 0 0 0 60 82 216 
57 57 65 57 43 0 0 0 0 0 0 0 0 0 99 98 0 0 0 0 0 0 0 140 
57 57 57 57 49 41 41 41 41 41 41 41 41 41 213 213 41 41 41 41 41 41 41 52 
57 57 65 57 57 57 57 57 57 57 57 57 57 57 57 57 57 57 57 57 57 57 57 57 
14 0
0 1
2
8 21 0
18 21 0
2
