<17><Abandoned Mine><54><43>
#####################
#.................###
#.#######.#.........#
#.d...dd..#######.#.#
#................x..#
#.###.###.#######.#.#
#x..#x..#x..#...#.#.#
#..d.d.d.d.d.d.d....#
#.#...#...#...#...###
#.###.###.#######.###
#s...d............###
#####################
