<5><Cat Attack><43><37>
################
##.#.########.##
#sx..########.##
#....########.##
##..x...#.....##
####.......x.###
####......x..###
###.x#####..####
###..#####..####
##...#####..####
################
