<22><Loop><26><20>
###############
#...x.....x...#
#..x.....#.##.#
#.#.........#.#
#.#.........#.#
#.#.#.....x...#
#s#>>>>>>>>>>v#
#^###########v#
#^<<<<<<<<<<<<#
###############