<21><I've seen this><20><12>
######################
###................###
###..................#
##s..............#.#.#
################.#.#.#
###>v>v>v>v>v>v>.....#
#................#.###
#...>^>^>^>^>^>^##.###
###.##############.###
###................###
######################
