<23><NaN><25><16>
################
#>.......v#.v<<#
#........<#.>>.#
#.##...x....##.#
#>>>>>>>>>s###.#
#.........x###.#
#x.....x...<v<.#
#>........^^<^<#
################