<13><Memento Mori><58><43>
##############
#####.xx.#####
###........###
##.x......x.##
#.d.xx..xx.d.#
#..###..###..#
#..###..###..#
#..###..###..#
#...x....x...#
#s...#..#....#
###xd....d.###
###.d....x.###
####.#..#.####
##############
