<2><Sticky slalom><26><18>
##########
#s.......#
#.#.#.##.#
#..x.....#
#....x...#
#.#.#.#.##
#.......##
##########
