<29><Altered Memories><45><35>
##################
#####..v.....#####
#####...##...#####
###..d..dd..d..###
###..#......#..###
#s........x......#
#.##.#......#.##.#
#.......dd..#.##.#
#..d.#......#.d..#
###..#......#..###
###^.#^.....#.^###
#######....#######
#######>^^<#######
##################
