<27><Igloo><36><23>
#################
#####v<<<<<<#####
###v<<##.##^<<###
##v<####.####^<##
##v#.........#^##
#v<#.#.#.#.#.#^<#
#v#>.#.....#.<#^#
#v#^..x.^.x..^#^#
#s......#.......#
#################
