<25><Old Pinball Machine><46><35>
#############
#>>v#...<<###
#^#v#..##^<##
#^v<#.x..#^<#
#..#......#^#
#x.....#..#.#
#...#.....#.#
#.....#...#.#
#..x.....x#.#
#....x....#.#
#....x....#.#
#...x..x..#.#
#.........#s#
#.#.....#.#.#
#^##v<^##^#^#
####>>^######
