<15><Crystal Ball><30><21>
############
####...#.s##
###.d.dx..##
##.dd.dddd.#
#.ddd.dddd.#
#....#.ddx##
#..dd..dd..#
##.dd..dd.##
###.x..x.###
###......###
############
