<28><Confusion><24><16>
##########
#vsx.v.v##
#...v...<#
#..>.....#
#....>...#
#...x....#
#.x.....<#
#>.^..^..#
##########
