<30><Our Goodbye><38><29>
#################
###....###....###
##v.....#.....<##
#...###.s..##...#
#.d....<.>....d.#
#.d.....x.....d.#
#.dd....x....dd.#
##>v####.####>^##
###>v###.###>^###
####>v##.##>^####
#####>v#.#>^#####
######>v.>^######
#######>.^#######
########^########
#################
