<15><Looks simple><30><21>
###########
########..#
##..d..#..#
##.#.#.#..#
#.d.d.d...#
#.x.d#....#
#..x...x..#
###...x...#
###.dd..d.#
####.s..d.#
###########
