<8><Arachnophobia><84><73>
####################
#########..###..####
######...#x.#.x#...#
########....x.x..###
####...###.#.#.#####
##.......#.#.#.#####
#.x.............####
#s........x.....####
##..x..........#####
####...###.#.#.#####
########..x#.#x..###
######...#.....#...#
#########..###..####
####################
