<10><Brainiac><95><89>
######################
#######...........####
####....#x.####.....##
###..####..####.###.##
##..#####....#..###..#
##....#...##...#####.#
#..##.#..#####..###..#
#.###.#..x...##..##.##
#.##..##.....###....##
#.##...####..#####.###
#s.###..###......#..##
##...#..#.....##....##
####..#.....#####.x.##
#####....#########...#
######################
