<19><Cursed Pyramid><74><58>
#####################
#........x.##########
#.###...x...##..#####
#.###.##.d...#.d...##
#........d..x.#.##.##
#..........#....##.##
###.#....x##....##.##
###...d...##.....#.##
###..#.##.###.x...x##
##.dx..##.###..dd..##
#s....###.....#.....#
#####################
