<26><Three Houses><52><43>
###################
#vs#..#.x..##>.x..#
#v....#....#v#>..x#
#v#...#....#.v#>v.#
#v#..##x.x.#x.v#>.#
#v#...#....#..>v#.#
#x....#....#.x....#
#v#####.####^######
#>>>>>>x>>>>^######
###################
