<12><Too long><16><13>
########################
#s......x..............#
#.......d......x.....x.#
#.......x............x.#
#..............x.......#
########################
