<4><Getting familiar><22><17>
###########
#s...x..###
#.#.......#
#.#.#.#.#.#
#.#..x..#.#
#.###.#.#.#
#.........#
###...#####
###########