<9><Haunted House><64><53>
###################
#############..####
#############..####
#######.....#..####
#####x.........####
###..x..........###
##...xx..........##
#......x......x...#
############..#.###
###.xx.......##.###
###.x.......##.x###
###x.......##.x.###
###s......##....###
###################