<24><Bouncy Ceiling><26><18>
##################
#vv#vvv#v#v#######
#...........######
#.x.........v#####
#..#........<#####
#......#.#..######
#........#....s.<#
#...........######
#.....#..#.^######
#....x...x.#######
#v^^#v#^#v########
#>^^<<#^<<########
##################
