24 24
13 14 0 0 0 0 0 0 0 0 0 0 0 0 0 0 0 0 0 0 0 0 15 16 
17 17 13 1 1 6 0 0 0 0 0 0 0 0 0 0 7 28 1 19 1 16 17 17 
17 17 17 17 17 9 1 19 1 28 23 0 0 0 0 0 240 17 17 17 17 17 17 17 
17 17 17 17 17 17 17 17 17 17 21 23 0 0 0 24 22 17 17 17 17 17 17 17 
17 17 17 17 17 17 17 17 17 17 17 3 0 0 0 8 238 2 2 2 2 11 17 17 
17 17 17 17 17 17 17 17 17 17 17 3 0 0 0 0 0 0 0 0 0 8 11 17 
17 17 17 17 17 17 17 17 17 17 17 3 0 0 0 0 0 0 0 0 0 0 4 17 
17 17 17 17 17 17 17 17 17 17 17 21 14 0 0 0 0 185 186 0 0 0 4 17 
17 17 17 17 17 17 17 17 17 17 17 17 17 13 1 19 19 187 188 23 0 0 4 17 
17 17 17 17 17 17 17 17 17 17 17 17 17 17 17 17 17 17 17 33 116 116 34 17 
17 17 17 17 17 17 17 17 17 17 17 17 17 17 17 17 17 17 17 3 0 0 4 17 
17 17 17 17 17 17 17 17 17 17 17 17 17 17 10 2 2 2 238 5 0 0 4 17 
17 17 17 17 17 17 17 17 17 17 17 10 2 2 5 0 0 0 0 0 0 0 4 17 
17 17 17 17 17 17 17 17 17 17 17 3 0 0 0 0 0 0 0 0 0 7 12 17 
17 17 17 17 17 17 10 2 238 2 2 5 0 0 0 0 0 0 0 0 0 240 17 17 
17 17 17 10 2 238 5 0 0 0 0 0 0 0 0 0 0 0 0 0 24 22 17 17 
17 10 2 5 0 0 0 0 0 0 0 0 0 0 0 0 0 7 1 1 22 17 17 17 
17 3 0 0 0 0 0 0 0 0 0 0 0 0 0 0 0 4 17 17 17 17 17 17 
17 3 0 0 0 0 0 0 0 0 0 0 0 0 0 0 0 4 17 17 17 17 17 17 
17 21 23 0 211 212 0 0 0 0 0 0 0 0 0 7 1 22 17 17 17 17 17 17 
17 17 21 19 231 232 14 0 0 0 0 111 0 0 0 4 17 17 17 17 17 17 17 17 
17 17 17 17 17 17 17 13 23 0 0 81 0 24 19 12 17 17 17 17 17 17 17 17 
17 17 17 17 17 17 17 17 21 1 72 213 73 12 17 17 17 17 17 17 17 17 17 17 
17 17 17 17 17 17 17 17 17 17 74 75 76 17 17 17 17 17 17 17 17 17 17 17 

0

0

50