80 32
143 0 0 0 0 0 0 0 0 0 0 0 0 0 107 147 106 0 0 0 0 0 0 0 0 0 0 0 0 0 107 129 129 106 0 0 0 0 0 0 0 144 101 129 106 0 0 0 0 0 0 0 0 0 0 0 0 0 0 0 0 0 0 0 0 0 0 0 0 0 0 0 0 0 0 0 0 0 0 0 
109 143 0 0 0 0 0 144 101 149 147 101 207 208 122 127 141 143 0 0 0 0 0 0 0 0 144 101 129 101 122 127 128 109 106 0 0 0 0 0 144 122 127 127 109 143 0 0 0 0 0 0 0 0 144 129 129 129 106 0 0 205 206 0 0 0 0 0 0 0 0 0 0 0 144 143 0 0 0 0 
127 109 106 0 0 0 144 122 127 127 127 127 227 228 127 127 127 141 143 0 0 0 0 0 144 101 142 127 127 127 130 127 127 127 109 129 101 101 129 101 142 127 128 127 127 109 129 101 106 0 0 0 0 144 122 127 127 127 109 101 101 225 226 101 143 0 0 0 0 107 129 101 101 101 142 141 147 106 0 0 
128 110 105 0 0 0 104 127 128 127 127 127 127 127 127 127 130 127 109 101 143 0 0 107 142 127 127 128 127 127 127 127 127 127 127 127 127 130 127 127 127 127 127 127 127 110 121 130 103 144 101 147 101 122 127 128 127 127 127 127 127 127 127 127 109 101 147 129 129 122 127 130 127 127 127 127 127 141 129 101 
127 103 0 0 0 107 122 127 127 127 127 127 127 127 127 127 127 127 127 127 109 129 129 142 127 127 127 110 102 102 168 168 102 102 168 168 102 168 168 168 102 102 121 127 127 103 108 102 105 104 127 127 127 127 127 127 127 127 127 130 127 127 127 127 127 127 127 127 127 127 127 127 127 127 127 128 127 127 127 130 
127 103 0 0 0 108 121 127 127 127 127 127 127 127 127 127 127 127 127 128 127 127 127 127 127 110 102 105 0 0 131 131 0 0 131 131 0 131 131 131 0 0 108 121 127 103 0 144 129 122 127 127 127 127 127 127 127 127 127 127 127 127 127 127 127 128 127 130 127 127 127 127 127 127 127 127 127 127 127 127 
127 141 106 0 0 0 108 121 130 127 127 127 127 127 127 127 127 127 127 127 127 127 127 127 127 103 0 0 0 0 131 131 0 0 131 131 0 131 131 131 0 0 0 108 121 163 116 164 127 128 127 127 130 127 110 178 102 102 102 194 121 127 127 127 127 110 102 194 102 102 102 178 121 127 127 130 127 127 127 127 
127 127 103 0 0 0 0 104 127 127 127 128 127 127 127 127 127 127 127 127 127 127 127 130 127 103 0 0 0 107 167 167 101 101 167 167 147 167 167 167 106 0 0 0 104 103 0 108 121 127 127 127 110 102 105 0 0 0 0 81 108 102 102 178 102 105 0 81 0 0 0 0 108 102 102 121 127 127 127 127 
127 128 109 106 0 0 0 108 102 102 121 127 127 127 127 127 127 127 127 127 127 128 127 127 110 105 0 0 0 108 178 102 178 102 178 102 178 102 178 102 105 0 0 0 104 103 0 0 108 121 127 110 105 0 0 0 0 0 0 81 0 0 0 0 0 0 0 81 0 0 0 0 0 0 0 108 121 127 128 127 
127 127 127 163 116 116 116 116 116 116 164 127 127 127 127 127 127 127 127 127 127 127 127 127 103 0 0 0 0 0 0 0 0 0 0 0 0 0 0 0 0 0 0 0 104 179 0 0 0 104 110 105 0 0 0 0 0 0 0 81 0 0 0 0 0 0 0 81 0 0 0 0 0 0 0 0 108 121 127 127 
127 127 130 109 149 106 0 0 0 0 108 121 127 127 127 127 127 127 127 110 102 102 102 178 105 0 0 0 0 0 0 0 0 0 0 0 0 0 0 0 0 0 0 0 104 109 106 0 0 180 103 0 0 111 0 0 0 0 0 81 0 0 0 0 0 0 0 81 0 0 0 0 0 0 0 0 0 104 127 127 
127 127 127 127 127 109 101 101 106 0 0 104 127 127 127 127 127 130 127 103 0 0 0 0 0 0 0 0 0 107 101 177 101 177 101 177 101 177 101 177 106 0 0 0 104 127 103 0 107 122 103 0 0 81 0 0 0 0 0 81 0 0 0 0 0 0 0 81 0 0 0 0 0 0 0 0 0 108 121 130 
127 128 127 127 127 127 128 127 103 0 0 104 127 127 127 127 127 127 110 105 0 0 0 0 0 0 0 0 0 108 168 178 168 102 168 178 168 102 168 178 105 0 0 0 104 130 103 0 104 127 195 132 82 84 0 0 0 0 107 193 106 0 0 0 0 0 107 193 106 0 0 0 0 0 0 0 0 0 104 127 
127 127 110 102 121 127 127 110 105 0 0 104 130 127 127 127 127 110 105 0 0 0 0 0 0 0 0 0 0 0 131 0 131 0 131 0 131 0 131 0 0 0 0 0 104 127 103 0 108 121 103 0 0 0 0 0 0 0 180 127 179 0 0 0 0 0 180 127 179 0 0 0 0 0 0 0 0 0 180 127 
127 110 105 0 108 121 130 103 0 0 107 122 127 127 127 127 127 103 0 0 0 107 147 101 106 0 0 0 0 0 131 0 131 0 131 0 131 0 131 0 0 0 0 0 104 127 103 0 0 180 109 106 0 0 0 0 0 0 108 178 105 0 0 0 0 0 108 178 105 0 0 0 0 0 0 0 0 0 104 127 
127 103 0 0 0 108 168 105 0 0 104 127 127 127 127 128 127 163 116 116 116 164 127 127 109 106 0 0 0 107 167 101 167 177 167 101 167 177 167 101 106 0 0 0 104 128 103 0 0 104 110 105 0 0 107 177 106 0 0 0 0 0 107 177 106 0 0 0 0 0 107 177 106 0 0 0 0 107 122 127 
127 103 0 0 0 0 131 0 0 0 104 127 127 127 127 127 110 105 0 0 107 122 127 127 127 103 0 0 0 104 127 130 127 127 127 127 127 127 128 127 103 0 0 0 104 127 103 0 0 104 103 0 0 0 180 127 179 0 0 0 0 0 180 127 179 0 0 0 0 0 180 127 179 0 0 0 0 104 127 127 
130 103 0 0 0 0 131 0 0 144 142 127 127 127 127 127 103 0 0 107 122 127 128 127 127 163 116 116 116 164 110 102 102 102 102 121 127 127 127 127 163 116 116 116 164 127 103 0 0 180 103 0 0 0 108 194 105 0 0 0 0 0 108 194 105 0 0 0 0 0 108 194 105 0 0 0 0 104 127 128 
110 105 0 0 107 129 167 101 147 142 127 127 127 127 127 110 105 0 0 104 130 127 127 127 127 103 0 0 0 104 103 0 144 143 0 108 102 121 127 127 103 0 0 0 104 110 105 0 0 104 109 106 0 0 0 81 0 0 0 0 0 0 0 81 0 0 0 0 0 0 0 81 0 0 0 0 0 180 127 127 
163 116 116 116 164 127 127 127 127 127 127 130 127 127 127 179 0 0 0 108 121 127 127 127 127 103 0 0 0 108 105 144 142 141 106 0 0 108 102 102 105 0 0 0 104 179 0 0 0 104 127 103 0 0 0 81 0 0 0 0 0 0 0 81 0 0 0 0 0 0 0 81 0 0 0 0 0 104 127 127 
103 0 0 0 108 102 121 127 128 127 110 102 102 102 121 103 0 0 0 0 104 127 127 127 130 103 0 0 0 0 144 142 128 127 141 129 101 106 0 0 0 0 0 0 104 103 0 0 107 122 128 103 0 0 0 81 0 0 0 0 0 0 0 81 0 0 0 0 0 0 0 81 0 0 0 0 0 104 130 127 
103 0 0 0 0 0 108 178 102 102 105 0 0 0 108 105 0 0 0 0 108 102 121 127 127 103 0 0 0 107 142 127 127 127 127 127 127 109 129 101 106 0 0 0 104 103 0 0 104 127 127 109 106 0 0 81 0 0 0 0 0 0 0 81 0 0 0 0 0 0 0 81 0 0 0 0 0 108 121 127 
109 106 0 0 0 0 0 0 0 0 0 0 0 0 0 0 0 0 0 0 0 0 108 121 127 179 0 0 0 108 178 102 102 102 102 102 102 102 102 102 105 0 0 0 180 103 0 0 108 121 127 130 109 101 106 81 0 107 101 177 106 0 0 81 0 107 101 177 101 101 101 193 106 0 0 0 0 0 180 127 
127 179 0 0 0 0 0 0 0 0 0 0 0 0 0 0 0 0 0 0 0 0 0 180 128 103 0 0 0 0 0 0 0 0 0 0 0 0 0 0 0 0 0 0 108 105 0 0 0 104 127 127 127 127 109 193 101 122 130 127 109 101 101 193 101 122 130 127 127 127 127 127 109 106 0 0 0 0 104 127 
130 103 0 0 0 0 0 0 0 0 0 0 0 0 0 0 0 0 0 0 0 0 0 108 121 103 0 0 0 0 0 0 0 0 0 0 0 0 0 0 0 0 0 0 0 0 0 0 0 104 127 127 127 127 127 127 127 127 127 127 127 128 127 127 127 127 127 127 127 127 127 127 130 103 0 0 0 0 104 127 
127 141 106 0 0 0 0 0 0 0 0 0 0 0 0 0 0 0 0 0 0 0 0 0 104 109 143 0 0 0 0 0 0 0 0 0 0 0 0 0 0 0 0 0 205 206 0 0 0 108 121 127 128 127 127 127 110 102 102 102 121 127 127 110 102 102 121 127 127 128 127 127 127 103 0 0 0 0 180 127 
127 127 103 0 0 0 0 0 0 0 0 0 0 0 0 0 0 0 0 0 0 0 0 0 104 127 141 143 0 0 0 0 0 0 0 0 0 0 0 0 0 144 101 147 225 226 106 0 0 0 108 102 102 168 102 102 105 0 0 0 108 102 168 105 0 0 108 121 127 127 127 110 102 105 0 0 0 107 122 127 
128 127 109 143 0 0 0 0 0 0 0 0 0 0 0 0 0 0 0 0 0 0 0 0 104 127 130 109 106 0 0 0 0 0 0 0 0 0 0 0 107 142 127 127 128 127 103 0 0 0 0 0 0 131 0 0 0 0 150 0 0 0 131 0 0 0 0 108 102 102 102 105 0 0 0 0 107 122 127 127 
127 127 127 103 0 0 0 0 0 0 0 0 0 0 0 0 0 0 0 0 0 107 101 147 122 127 127 127 109 101 101 101 101 101 101 101 101 101 101 101 122 127 127 127 127 127 109 106 0 0 0 0 0 131 0 0 0 0 94 0 0 0 131 0 0 0 0 0 0 0 0 0 0 0 0 107 122 127 128 127 
127 127 130 141 106 0 0 0 0 0 125 101 101 101 124 0 0 0 0 0 107 122 127 127 127 127 127 127 127 127 127 127 127 130 127 127 127 127 128 127 127 127 127 127 127 127 130 103 0 0 0 0 0 131 0 0 0 107 193 101 101 101 167 101 101 106 0 0 189 190 0 0 0 107 101 122 127 127 127 127 
127 127 127 127 109 101 101 101 101 126 127 127 127 130 127 123 101 101 101 101 122 127 128 127 127 127 127 127 127 127 128 127 127 127 127 127 127 127 127 127 127 127 127 127 127 127 127 109 101 101 101 101 101 167 101 101 101 122 127 128 127 127 127 127 127 109 101 101 191 192 101 101 101 122 127 127 130 127 127 127 
127 127 127 127 130 127 127 127 127 128 127 127 127 127 127 127 127 127 127 130 127 127 127 127 127 127 127 127 127 127 127 127 127 127 127 127 127 127 127 127 127 130 127 127 127 127 127 127 127 128 127 127 127 127 127 127 127 127 127 127 127 127 127 127 127 130 127 127 127 127 127 127 127 127 128 127 127 127 127 130 

2
6 33 2
35 33 2

1
