24 16
1 1 1 1 1 28 6 0 0 0 0 0 7 28 1 1 1 1 1 23 24 1 1 1 
17 17 17 17 18 17 3 0 0 0 0 0 4 17 20 17 17 18 17 21 22 17 17 17 
17 17 20 17 17 17 3 0 0 0 0 0 8 2 2 2 11 17 17 20 17 17 18 17 
17 17 17 17 20 17 3 0 0 0 0 0 0 0 0 0 8 2 234 11 17 17 17 17 
17 17 17 17 17 17 3 0 0 0 0 0 0 0 0 0 0 0 81 8 2 11 17 17 
17 17 17 17 17 17 3 0 0 0 0 0 0 0 0 0 0 0 100 93 82 236 17 17 
17 18 17 17 17 17 21 23 0 0 0 0 0 0 0 0 0 0 0 0 0 4 17 18 
17 17 17 17 17 17 17 9 72 73 1 14 0 0 0 0 0 0 0 0 0 4 17 17 
17 17 17 17 18 17 17 17 74 76 17 17 13 23 0 0 0 0 0 0 0 4 17 17 
17 17 17 17 17 17 17 20 17 17 17 17 17 3 0 0 0 0 0 0 0 4 17 20 
17 17 17 17 17 17 17 17 17 17 18 17 17 3 0 0 0 0 0 0 0 4 17 17 
17 17 17 20 17 17 17 17 17 17 17 17 17 3 0 0 0 0 0 0 0 4 17 17 
17 17 17 17 17 17 17 18 17 20 17 17 17 3 0 0 0 0 0 0 0 4 18 17 
17 17 17 17 17 17 17 17 17 17 17 17 17 9 6 0 0 111 0 0 0 4 17 17 
17 17 18 17 17 17 17 17 17 17 17 18 17 17 21 23 0 92 0 0 7 22 17 17 
17 17 17 17 17 17 20 17 17 17 17 17 17 17 17 21 1 233 1 1 22 17 17 18 

0

0
