24 16
0 0 0 0 0 0 0 0 0 0 0 0 0 0 0 0 0 0 0 0 0 0 0 0 
0 0 0 0 0 0 0 0 211 212 0 0 0 0 0 0 0 0 0 0 0 0 0 0 
19 1 28 6 0 7 28 1 231 232 23 0 7 1 27 1 23 0 0 7 1 1 19 1 
17 10 2 5 0 8 2 11 20 17 21 1 12 18 17 17 9 1 1 12 17 17 17 17 
17 239 0 0 0 0 0 8 2 2 11 17 17 17 17 17 18 17 17 17 17 17 17 17 
17 3 0 0 0 0 0 0 0 0 8 38 2 38 2 2 2 2 2 2 11 17 17 17 
17 21 6 0 0 0 0 0 0 0 0 131 0 131 0 0 0 0 0 0 8 2 11 17 
17 17 21 23 0 0 0 0 0 0 0 131 0 131 0 0 0 0 0 0 0 0 4 17 
17 17 17 21 14 0 0 0 0 0 0 131 0 131 0 0 0 0 0 0 0 0 4 18 
17 18 17 17 17 13 14 0 0 0 0 131 0 131 0 7 23 0 0 0 0 0 4 17 
17 17 17 17 20 17 17 13 1 6 0 131 7 37 19 12 3 0 0 0 0 0 4 17 
17 17 17 17 17 17 18 17 17 9 1 37 12 17 17 17 3 0 0 0 111 0 8 11 
17 17 17 17 17 17 17 17 17 20 17 17 17 17 18 17 9 1 6 0 92 0 0 4 
17 17 17 17 17 17 17 17 17 17 17 17 17 17 17 17 20 17 21 6 81 0 0 4 
17 17 17 18 17 17 17 17 17 18 17 17 17 17 17 17 17 17 17 21 233 1 1 12 
17 17 17 17 17 17 17 17 17 17 17 17 17 17 17 17 17 17 18 17 17 17 17 17 

0

0
