32 24
223 0 0 0 0 0 0 0 0 0 209 210 0 0 0 0 0 0 0 0 0 0 0 0 0 0 0 0 0 0 0 0 
224 46 0 0 47 41 197 41 41 41 229 230 41 41 46 0 0 47 41 41 41 41 41 41 41 41 41 41 41 41 41 41 
65 43 0 0 44 57 57 57 57 57 65 57 57 57 43 0 0 48 42 42 42 42 218 42 69 42 42 42 42 218 51 57 
57 43 0 0 44 57 50 42 42 42 69 218 51 57 43 0 0 0 0 0 0 0 0 0 0 0 0 0 0 0 44 57 
57 43 0 0 44 57 43 0 0 0 0 0 44 57 43 0 0 0 0 0 0 0 0 0 0 0 0 0 0 0 44 65 
57 219 0 0 44 65 43 0 0 111 0 0 44 57 219 0 0 0 0 0 0 0 0 0 0 0 0 0 0 0 44 57 
57 43 0 0 44 57 215 82 95 97 0 0 44 57 43 0 0 0 0 0 0 0 0 0 223 0 0 0 0 0 44 57 
57 43 0 0 44 57 43 0 0 0 0 0 44 65 61 41 41 41 197 41 41 41 41 41 224 41 41 46 0 0 44 57 
57 43 0 0 44 57 219 0 0 0 0 0 44 57 57 57 57 57 57 57 57 65 57 57 57 57 57 43 0 0 44 57 
65 219 0 0 44 57 43 0 0 0 0 0 48 42 42 42 42 198 42 198 42 198 42 198 42 51 65 43 0 0 44 65 
57 43 0 0 44 57 43 0 0 0 0 0 0 0 0 0 0 0 0 0 0 0 0 0 0 200 57 43 0 0 44 57 
57 43 0 0 220 57 43 0 0 0 0 0 0 0 0 0 0 0 0 0 0 0 0 0 0 44 57 43 0 0 44 57 
57 43 0 0 44 65 49 41 41 41 41 41 46 0 0 47 41 41 197 41 197 41 197 41 41 62 57 43 0 0 44 57 
57 43 0 0 44 57 57 57 57 57 57 57 43 0 0 48 42 68 42 42 42 42 51 65 65 65 65 43 0 0 44 57 
57 43 0 0 44 57 57 57 57 57 65 57 43 0 0 0 0 0 0 0 0 0 44 65 65 65 65 43 0 0 44 57 
57 43 0 0 44 57 57 57 57 57 57 57 43 0 0 0 0 0 0 0 0 0 44 65 65 65 65 43 0 0 44 57 
57 43 0 0 220 57 57 57 57 57 57 57 43 0 0 0 0 0 0 0 0 0 48 42 68 42 51 43 0 0 44 65 
57 43 0 0 44 57 65 57 57 57 57 57 43 0 0 0 0 0 0 0 0 0 0 0 0 0 44 43 0 0 44 57 
57 43 0 0 44 57 57 57 57 57 65 57 43 0 0 0 0 0 0 0 0 0 0 0 0 0 44 43 0 0 44 57 
57 43 0 0 48 69 42 214 214 42 42 51 43 0 0 0 0 0 0 0 0 0 47 46 0 0 48 45 0 0 44 57 
57 43 0 0 0 0 0 133 134 0 0 44 43 0 0 0 0 0 0 0 0 0 44 43 0 0 0 0 0 0 44 57 
65 43 0 0 0 0 0 135 136 0 0 44 49 41 41 41 41 41 41 41 41 41 52 43 0 0 0 0 0 0 44 57 
57 49 41 41 41 41 41 213 213 41 41 52 57 57 57 57 57 65 57 57 57 57 57 61 41 41 41 41 41 41 52 65 
57 57 57 57 57 65 57 57 57 57 57 57 57 57 57 65 57 57 57 57 65 57 57 57 57 57 57 57 57 57 57 57 

1

18 26 0

2
