0
0
20
15
####################
#                  #
#                  #
#5 6               #
# 7 8         k    #
##==################
#   #       #$B    #
#   #       #$B    #
#   #  ###  ####   #
# A #   %#  #      #
# A ######  #   ####
#   A       #      #
#      A    ####   #
#                  #
####################
