0
0
20
20
####################
#       B          #
#                  #
#  ############    #
#  #          #    #
#  #          #    #
# A#  ######  #    #
#  #  #ffff#  #    #
#  #  # 5  #  #    #
#  #  #  6 #  #   A#
#  #  # 7  #  #    #
#  #  #  8 #  #    #
#  #       #  #    #
#  #########  #    #
#             #    #
#             #    #
###############    #
#  $A$A$A$A$A$     #
#  $$A$A$A$A$$  %  #
####################
