<9><Level 9><29><26>
######################
#s...................#
##...................#
##..................##
###.................##
###................###
####...............###
####..............####
##########........####
##########.###########
####.............#####
####..............####
###...............####
###................###
####...............###
######################