<16><Level 16><46><36>
##################
##......##########
##.####..###..####
#......#.###.....#
#...##.#.###.#.#.#
#.#..#s#.........#
#.##..##.##..#.###
#.###....##.##.###
#...#######.#..###
###...........####
##################