<19><Level 19><42><31>
###############
#s....#.......#
#.........#...#
##.##.#####.###
##.#....#.....#
#.........#.#.#
#.....#.......#
##.#.##.#.#.###
##............#
##......#....##
###############