<18><Level 18><34><23>
##############
#s...####....#
#.##.####.##.#
#.##.####.##.#
#....###.....#
####......####
#####.##..####
###...##...###
###........###
###..####..###
###..####..###
##############