<1><Level 1><5><3>
#######
#s###.#
#.###.#
#.###.#
#.###.#
#.....#
#######