<17><Level 17><36><26>
######################
###................###
###..................#
##s..............#.#.#
################.#.#.#
###...#...#...#......#
#................#.###
#...#...#...#...##.###
###.##############.###
###................###
######################