<2><Level 2><9><6>
##########
#s.....#.#
######.#.#
#......#.#
#.######.#
#........#
##########