<30><Level 30><28><21>
##########
#s..#...##
##....#..#
#........#
#..#..#..#
#........#
##.#..#.##
##.......#
####....##
##########