fleet
jump
up down left
0
      ###########
      #        ##
      #        ##
      #     !   #
      #  h      #
      #    ---  #
      #    #    #
############    #
>               x
########        #
########        #
####>           x
##              #
##          #####
#>          #   #
###       @ #   #
#################
