pachinko
down
down left
1
wait 60 hold down 5
#################
                <
#-----------#####
##              x
###      ---#   #
>           x   <
###      ---#   #
##          x   x
#    ---#####   #
           x    <
  ##----#####   #
          x     <
 ###---######   #
       x        x
 ---#########   #
 @     x      ! <
#################

a