Scaffold
up

0
#################
#          ######
# !         #####
#####        ####
##           ####
>             ###
#             ###
#####          ##
##             ##
>              ##
#@              #
#####           #
##              #
#  X     X X   x#
#xx  xX x    xxx#
##xxxx  xxX xxx##
###xxxX xx  xx###