Stay!


2
wait 150 hold left 30
wait 150 hold right 30

#########
#       #
#   !   #
#       #
#-------#########
#       z     z #
#       z     z #
#---    z     z #
# f     z     z #
#############---#
#        ##     #
#         #---  #
# @             #
####          f #
   ##############
                

