⣿⣿⣿⣿⣿⠟⠉⠁⠄⠄⠄⠈⠙⠿⣿⣿⣿⣿⣿⣿⣿⣿⣿⣿ 
⣿⣿⣿⣿⠏⠄⠄⠄⠄⠄⠄⠄⠄⠄⠸⢿⣿⣿⣿⣿⣿⣿⣿⣿ 
⣿⣿⣿⣏⠄⡠⡤⡤⡤⡤⡤⡤⡠⡤⡤⣸⣿⣿⣿⣿⣿⣿⣿⣿ 
⣿⣿⣿⣗⢝⢮⢯⡺⣕⢡⡑⡕⡍⣘⢮⢿⣿⣿⣿⣿⣿⣿⣿⣿ 
⣿⣿⣿⣿⡧⣝⢮⡪⡪⡪⡎⡎⡮⡲⣱⣻⣿⣿⣿⣿⣿⣿⣿⣿ 
⣿⣿⣿⠟⠁⢸⡳⡽⣝⢝⢌⢣⢃⡯⣗⢿⣿⣿⣿⣿⣿⣿⣿⣿ 
⣿⠟⠁⠄⠄⠄⠹⡽⣺⢽⢽⢵⣻⢮⢯⠟⠿⠿⢿⣿⣿⣿⣿⣿ 
⡟⢀⠄⠄⠄⠄⠄⠙⠽⠽⡽⣽⣺⢽⠝⠄⠄⢰⢸⢝⠽⣙⢝⢿ 
⡄⢸⢹⢸⢱⢘⠄⠄⠄⠄⠄⠈⠄⠄⠄⣀⠄⠄⣵⣧⣫⣶⣜⣾ 
⣧⣬⣺⠸⡒⠬⡨⠄⠄⠄⠄⠄⠄⠄⣰⣿⣿⣿⣿⣿⣷⣽⣿⣿ 
⣿⣿⣿⣷⠡⠑⠂⠄⠄⠄⠄⠄⠄⠄⣿⣿⣿⣿⣿⣿⣿⣿⣿⣿ 
⣿⣿⣿⣿⣄⠠⢀⢀⢀⡀⡀⠠⢀⢲⣿⣿⣿⣿⣿⣿⣿⣿⣿⣿ 
⣿⣿⣿⣿⣿⢐⢀⠂⢄⠇⠠⠈⠄⣿⣿⣿⣿⣿⣿⣿⣿⣿⣿⣿ 
⣿⣿⣿⣿⣧⠄⠠⠈⢈⡄⠄⢁⢀⣾⣿⣿⣿⣿⣿⣿⣿⣿⣿⣿ 
⣿⣿⣿⣿⣿⡀⠠⠐⣼⠇⠄⡀⠸⣿⣿⣿⣿⣿⣿⣿⣿⣿⣿⣿ 
⣿⣿⣿⣿⣯⠄⠄⡀⠈⠂⣀⠄⢀⠄⠈⣿⣿⣿⣿⣿⣿⣿⣿⣿ 
⣿⣿⣿⣿⣿⣶⣄⣀⠐⢀⣸⣷⣶⣶⣶⣿⣿⣿⣿⣿⣿⣿⣿⣿